1 1 1 1 1 1 1 1 1 1 1 1 1 1 1
1 0 0 0 0 0 0 0 0 0 0 0 0 0 1
1 0 0 0 0 0 6 6 0 0 0 0 0 0 1
1 0 4 0 0 5 0 0 0 0 0 0 0 0 1
1 0 0 0 0 5 0 0 0 0 0 0 0 0 1
1 0 0 0 0 0 0 0 0 0 0 0 0 0 1
1 0 0 0 1 0 7 0 0 0 0 0 0 0 1
1 0 0 0 0 0 0 0 0 0 10 0 0 0 1
1 0 0 0 8 0 9 0 0 0 10 0 0 0 1
1 0 0 0 0 0 0 0 0 0 10 0 0 0 1
1 0 0 0 0 0 0 0 0 0 0 0 0 0 1
1 0 0 0 0 0 0 0 0 0 0 0 0 0 1
1 1 1 1 1 1 1 1 1 1 1 1 1 1 1

obj:
    {6.5, 5.5, 3};
    {7.5, 5.5, 3};
    {5.5, 5.5, 3};
	{5.5, 5.5, 3};
	{23.5, 25.1, 3};
	{-100.5, 5.5, 3};
